Do zrobienia:
- Klasy i itemy
- Rozbudowa misji
- Rozbudowa kasyna: Crash, Jackpot, Coin 1vs1 + cvary
- Zmiana sposobu wyswietlania opisu itemu (jako menu, dodatkowo wartosci ulepszen)
- Podglad skinow
- Daily Rewards
- Itemy:
* Sakkubus - Wyglądasz jak przeciwnik, masz tylko nóż, a twoje ataki powodują zatrucie i oślepienie
* Pentagram - Naznacza wroga. Twoja śmierć jest równa jego i na odwrót
* Bron Biologiczna - Masz 3 granaty zatrowajace | codperk_bronbiologiczna.sma
* Chwilowka - Po uzyciu na 30 sekund dostajesz AutoLame
* Dzialo Orbitalne - Po uzyciu zostaje wystrzelona wiazka laserowa zabijajaca wszystkich wrogow. Item niszczy sie po uzyciu. | codperk_dzialoorbitalne.sma
* Fala Smierci - Po uzyciu co sekunde zadaje 5 obrazen przeciwnikom przez 10 sekund
* Fala Soniczna - Po uzyciu ktora zadaje 75-100 (+int) obrazen przeciwnikom w zasiegu 500 (+int) jednostek
* Napalm - Dostajesz 3-5 granaty, ktore dodatkowo podpalaja wrogow po eksplozji
* Mrozaca Mgla - Dostajesz 2 smoki zamrazajace
* Geniusz - Dostajesz +75-100 inteligencji
* Granat Odlamkowy - Posiadasz 2 granaty odlamkowe, ktory rozpadaja sie na kilka odlamkow zadajacych 40 (+int) dmg | codperk_granatodlamkowy.sma
* Blogoslawienstwo - Po uzyciu jestes niesmiertelny do konca rundy. Item niszczy sie po uzyciu.
* Modul Odrzutowy - Wyrzuca cie z sila 666 (+int), modul laduje sie co co 5-6 sekund | codperk_modulodrzutowy.sma
* Kameleon - Z AUG masz ubranie CT, a z Kriegiem ubranie TT
* Okulary Obroncy - Widzisz miny i dostajesz +30-40 zdrowia
* Scyzoryk - Masz trzykrotnie zwiekszony zasieg noza | codperk_knife_attack_distance.sma
* Pierscien Teleportacji - Masz nielimitowany teleport
* Likwidator Amunicji - Masz 1/5-6 na wyczyszczenie magazynka przeciwnika przy trafieniu
* Glowka Pracuje - Dostajesz +40-60 expa za trafienie w glowe
* Umilowanie Zycia - Dostajesz +75-100 zycia
* Wytrenowany Weteran - Dostajesz +75-100 zycia, ale tracisz 50 kondycji
* Magiczny Noz - Z wyjetym nozem jestes niesmiertelny, ale nie mozesz sie ruszac
* Tytanowy Pancerz - Otrzymywane obrazenia sa zredukowane o 15-25 procent
* Scout Pikusia - Masz 1/2 na natychmiastowe zabicie ze Scouta i +20-30 zdrowia
* Wampirze Pociski - Polowa zadanych obrazen zamieniana jest na zdrowie
* Naboje GPS - Po trafieniu z pistoletu cala druzyna widzi przeciwnika na radarze
* Naboje Pulkownika - Zadajesz o 30-50% wiecej obrazen. Tracisz 50 zdrowia.
* Nalot - Mozesz raz w rundzie wezwac w wybrane miejsce nalot bombowy zadajacy 75 (+int) obrazen | codperk_Nalot.sma
* Narzedzia Pirotechnika - Mozesz natychmiastowo podlozyc lub rozbroic bombe | codperk_narzedziapirotechnika.sma
* Znacznik - Uzyj aby oznaczyc przeciwnika i drugi raz aby teleportowac sie za niego | codperk_nazwaczony.sma
* Mistrz Chowanego - Jestes w pelni niewidzialny do momentu otrzymania obrazen
* Cichacz - Jestes niemal niewidzialny podczas chodzenia na SHIFT
* Bogacz - Dostajesz 10000-15000$ co runde
* Ogniste Miny - Dostajesz dwie miny, ktore dodatkowo podpalaja po wybuchu
* Trujace Rakiety - Dostajesz dwie rakiety, ktore dodatkowo zatruwaja wybuchu
* Pogromca Replik - Repliki nie odbijaja twoich kul, niszczysz je dwa razy szybciej
* Powrot do Przeszlosci - Uzyj, a po 5 sekundach wszyscy poza toba zostana cofnieci w czasie. Wrogowie straca dodatkowo po 25hp. | codperk_powrotdoprzeszlosci.sma
* Bron z Przemytu - Dostajesz AK47 i M4A1, z ktorych zadajesz o 25-30 procent wieksze obrazenia
* Egzoszkielet - Mozesz odbijac sie od scian. Dostajesz 20-30 wytrzymalosci | codperk_pudziana.sma
* Rozblysk - Uzyj, aby oslepic wrogow w promieniu 350 (+int) jednostek | codperk_rozblysk.sma
* Honorowe Kule - Masz 1/2-3 szansy na kradziez 1 honoru przy trafieniu
* Kamizelka - Dostajesz tyle kamizelki ile masz wytrzymalosci
* Dezorientoracja - Masz 1/3-6 szansy na ukrycie celownika przeciwnika | codperk_sztukadezorientacji.sma
* Tajemnica CS-Reload.pl - Po uzyciu masz natychmiastowe zabicie z kazdej broni i +100 zdrowia. Item niszczy sie po uzyciu.
* Super Glock - Dostajesz Glocka, ktory nie ma odrzutu i zadaje +20-30 obrazen
* Teleport - Uzyj, aby zapisac miejsce. Po drugim uzyciu zostaniesz w nie przeteleportowany.
* Ubranie Szpiega - Posiadasz ubranie wroga i 1/10 szansy na spawn na respie wroga.
* Niebianskie TMP - Dostajesz TMP, ktore zadaje potrojne obrazenia
* Wszechwidzacy - Widzisz miny i niewidzialnych | codperk_wszechwidzacy.sma
* Wyszkolenie Sanitarne - Co 5 sekund dostajesz 6-12 HP
* Zabojca Komandosow - Jesli ofiara trzyma noz zginie natychmiastowo, gdy ja trafisz
* Zadyma - Masz nielimitowane Smoki
* Tajemnica Rushera - Masz 1/3 na zabicie z M3. Dostajesz +20-30 kondycji
* Zwinne Palce - Natychmiastowe przeladowanie broni | codperk_zwinnepalce.sma
* Amulet Cienia - Stajesz sie niewidzialny na 2 sekundy po otrzymaniu obrazen
* Honorowa Glowa - Dostajesz 1-2 honoru za kazde zabojstwo z HeadShotem
* Famas Grozy - Dostajesz Famasa z ograniczonym rozrzutem i masz 1/7-8 szansy na natychmiastowe zabicie z niego.